2
XXXXX
X   X
X * X
X   X
XX XXXXXXXXXXXXXXXXXXXXXX
X   X   X   X   X   X   X
X           X           X
X   X   X   X   X   X   X
XX XXXXXXX XXX XXX XXXXXX
X   X   X   X   X   X
X       X           X
X   X   X   X   X   X
XX XXXXXXXXXXXXXXXXXX
X   X
X   X
X   X
XXXXX
_____
XXXXX
X   X
X * X
X   X
XXXXX
_____

1
XXXXXXXXXXXXXXXXXXXXX XXXXXXXXXXXXXXXXXXXXX
X X X X X X XXXXXXXXXXXXX X X
X X X X XXXXXXXXXXXXX X X
X X X X X X XXXXXXXXXXXXX X X
XXXXXX XXX XXXXXXXXXX XXXXXXXXXXXXXXXXXXXXX
X X X X X X X XXXXXXXXXXXXXXXXX
X X * X X XXXXXXXXXXXXXXXXX
X X X X X X X XXXXXXXXXXXXXXXXX
XXXXXXXXXXXXXXXXXXXXX
